"SEED"	"rev_compl"
"TGTACAG"	"CUGUACA"
"TATACAA"	"UUGUAUA"
"TGTACAA"	"UUGUACA"
"TATACGA"	"UCGUAUA"
"TATACGG"	"CCGUAUA"
"TATACAG"	"CUGUAUA"
"TGCGCAA"	"UUGCGCA"
"GGAATGT"	"ACAUUCC"
"AAGCTTG"	"CAAGCUU"
"ACAGTAC"	"GUACUGU"
"GCAGCAT"	"AUGCUGC"
"CGGATGT"	"ACAUCCG"
"TGCAATG"	"CAUUGCA"
"CGCACTG"	"CAGUGCG"
"AAATTCG"	"CGAAUUU"
"CAGATTC"	"GAAUCUG"
"TTCCGGC"	"GCCGGAA"
"AGGACAC"	"GUGUCCU"
"ACGCCAT"	"AUGGCGU"
"AAGGCAC"	"GUGCCUU"
"CAGATGA"	"UCAUCUG"
"CCCGGGA"	"UCCCGGG"
"CGCCCTT"	"AAGGGCG"
"GCTTTGC"	"GCAAAGC"
"AAATGAG"	"CUCAUUU"
"CAGGTGA"	"UCACCUG"
"CGGGTTA"	"UAACCCG"
"CACAAGT"	"ACUUGUG"
"CGTACCG"	"CGGUACG"
"AAGTCTT"	"AAGACUU"
"CCTGTTC"	"GAACAGG"
"TGGACTG"	"CAGUCCA"
"CGGATCC"	"GGAUCCG"
"GTGCCTG"	"CAGGCAC"
"ACGTAGA"	"UCUACGU"
"AGTACTG"	"CAGUACU"
"CACAGTG"	"CACUGUG"
"GCAGGAC"	"GUCCUGC"
"TCTAGCC"	"GGCUAGA"
"AGCCCTT"	"AAGGGCU"
"TAGGCCG"	"CGGCCUA"
"AGTGGGG"	"CCCCACU"
"ATCTGGG"	"CCCAGAU"
"TGCAGCT"	"AGCUGCA"
"CTCGGCG"	"CGCCGAG"
"AGTGCAA"	"UUGCACU"
"AACAGTC"	"GACUGUU"
"TTGGTCC"	"GGACCAA"
"CTGTGGG"	"CCCACAG"
"TCCTGGG"	"CCCAGGA"
"ATAGGGA"	"UCCCUAU"
"TGTAGGG"	"CCCUACA"
"ATCATCG"	"CGAUGAU"
"TATTGCT"	"AGCAAUA"
"CTACTTC"	"GAAGUAG"
"CTATTTC"	"GAAAUAG"
"GGAGACG"	"CGUCUCC"
"ACCACAG"	"CUGUGGU"
"AACACTG"	"CAGUGUU"
"GTAGTGT"	"ACACUAC"
"GAGATGA"	"UCAUCUC"
"ACAGTAT"	"AUACUGU"
"GATTCCT"	"AGGAAUC"
"CTCTGAA"	"UUCAGAG"
"GCCCTGT"	"ACAGGGC"
"TGTGCGG"	"CCGCACA"
"CAGTGCA"	"UGCACUG"
"GGGAGGG"	"CCCUCCC"
"TGGTACA"	"UGUACCA"
"TAGACTG"	"CAGUCUA"
"TGCATAG"	"CUAUGCA"
"ATCATAC"	"GUAUGAU"
"TCCTACA"	"UGUAGGA"
"AGGCCAT"	"AUGGCCU"
"GAATCAT"	"AUGAUUC"
"CAGTATT"	"AAUACUG"
"CAATATT"	"AAUAUUG"
"CTGCAGT"	"ACUGCAG"
"CCACTGA"	"UCAGUGG"
"CCATCGA"	"UCGAUGG"
"TCACTGA"	"UCAGUGA"
"ACCATCG"	"CGAUGGU"
"CACCGGG"	"CCCGGUG"
"GGTTCTA"	"UAGAACC"
"TGAATTA"	"UAAUUCA"
"GGACGGA"	"UCCGUCC"
"GGGGCTG"	"CAGCCCC"
"CCCAAAG"	"CUUUGGG"
"CGTGTCT"	"AGACACG"
"TCCCACA"	"UGUGGGA"
"CTGCCCT"	"AGGGCAG"
"GCCCTAA"	"UUAGGGC"
"CGGCCGC"	"GCGGCCG"
"TATATAT"	"AUAUAUA"
"CTGCGCT"	"AGCGCAG"
"ACCAGGC"	"GCCUGGU"
"CTGCCCC"	"GGGGCAG"
"TGCCAAT"	"AUUGGCA"
"ACTGGCC"	"GGCCAGU"
"CAGTGGG"	"CCCACUG"
"GGCAACA"	"UGUUGCC"
"CGACAGC"	"GCUGUCG"
"TCACCAC"	"GUGGUGA"
"CAGTAGT"	"ACUACUG"
"GTGCAAA"	"UUUGCAC"
"AATACTG"	"CAGUAUU"
"GAGGTAT"	"AUACCUC"
"TGAAATG"	"CAUUUCA"
"CTGGGAA"	"UUCCCAG"
"ATTTCAG"	"CUGAAAU"
"TAAGACG"	"CGUCUUA"
"CTGCATT"	"AAUGCAG"
"CTGTAGT"	"ACUACAG"
"AACACCA"	"UGGUGUU"
"TGTGCGT"	"ACGCACA"
"CAGGGAC"	"GUCCCUG"
"GAGCCTC"	"GAGGCUC"
"ATCAGAA"	"UUCUGAU"
"CTCCCAT"	"AUGGGAG"
"CAGCAGG"	"CCUGCUG"
"CTGTCAT"	"AUGACAG"
"CACACTT"	"AAGUGUG"
"TGGTTCC"	"GGAACCA"
"ATGGTTC"	"GAACCAU"
"GAGTTGA"	"UCAACUC"
"GAATTGT"	"ACAAUUC"
"AGCTGCC"	"GGCAGCU"
"GCTACAT"	"AUGUAGC"
"GTCAGTT"	"AACUGAC"
"AAATGGT"	"ACCAUUU"
"GACAGCG"	"CGCUGUC"
"TTGTCCT"	"AGGACAA"
"TCACATT"	"AAUGUGA"
"GGCTCAG"	"CUGAGCC"
"GCAGAGG"	"CCUCUGC"
"ATTGCAC"	"GUGCAAU"
"ATCATGG"	"CCAUGAU"
"CTATTCT"	"AGAAUAG"
"CTGTTCT"	"AGAACAG"
"TCACAGT"	"ACUGUGA"
"ACTAGAT"	"AUCUAGU"
"AGGGTTG"	"CAACCCU"
"ATGTGGG"	"CCCACAU"
"AGCACCA"	"UGGUGCU"
"AAGTGCT"	"AGCACUU"
"TTTCAGT"	"ACUGAAA"
"TGGGAGG"	"CCUCCCA"
"TGGGAGA"	"UCUCCCA"
"GCTATGC"	"GCAUAGC"
"AAATAGA"	"UCUAUUU"
"ATCTGGC"	"GCCAGAU"
"CCCCTTC"	"GAAGGGG"
"GCTTTTG"	"CAAAAGC"
"TATACCT"	"AGGUAUA"
"GATATTT"	"AAAUAUC"
"ATGCTAG"	"CUAGCAU"
"GAGGAGA"	"UCUCCUC"
"AAGGAGG"	"CCUCCUU"
"GAAGGGG"	"CCCCUUC"
"GGGGCGG"	"CCGCCCC"
"CACGCGG"	"CCGCGUG"
"TGGCCAT"	"AUGGCCA"
"GCTCTGC"	"GCAGAGC"
"AATTTAG"	"CUAAAUU"
"ACCTTGC"	"GCAAGGU"
"ACATTAC"	"GUAAUGU"
"CCAATAC"	"GUAUUGG"
"CTCTGGG"	"CCCAGAG"
"TGGCCCT"	"AGGGCCA"
"ACACACC"	"GGUGUGU"
"CAAAGCA"	"UGCUUUG"
"CCCCTGG"	"CCAGGGG"
"TTTTCAT"	"AUGAAAA"
"TCCTATA"	"UAUAGGA"
"CCAGCAT"	"AUGCUGG"
"GAGCGCC"	"GGCGCUC"
"AATGTTT"	"AAACAUU"
"AGTGCCT"	"AGGCACU"
"CCGTCTC"	"GAGACGG"
"CTCACAC"	"GUGUGAG"
"CCCTGAA"	"UUCAGGG"
"AATCAGC"	"GCUGAUU"
"AATCACT"	"AGUGAUU"
"ATCACTA"	"UAGUGAU"
"CTCCGTG"	"CACGGAG"
"CCCCCAG"	"CUGGGGG"
"TGTGAAG"	"CUUCACA"
"CAAAAAA"	"UUUUUUG"
"AGCCTTC"	"GAAGGCU"
"ATCAGCA"	"UGCUGAU"
"GGACCAT"	"AUGGUCC"
"CACCTGA"	"UCAGGUG"
"AATGCCC"	"GGGCAUU"
"ATAATAC"	"GUAUUAU"
"CCTGCTG"	"CAGCAGG"
"AGTGCCG"	"CGGCACU"
"TTATCAG"	"CUGAUAA"
"TTAGCAG"	"CUGCUAA"
"TTGTTCG"	"CGAACAA"
"TCATAGA"	"UCUAUGA"
"ACATAGA"	"UCUAUGU"
"TCACACA"	"UGUGUGA"
"CTGGACT"	"AGUCCAG"
"ATGTAAC"	"GUUACAU"
"ATGTAAT"	"AUUACAU"
"ATACAAG"	"CUUGUAU"
"ATCATTC"	"GAAUGAU"
"CAGCACT"	"AGUGCUG"
"GTCCTCT"	"AGAGGAC"
"TATGTAT"	"AUACAUA"
"AGCCCGG"	"CCGGGCU"
"TTCAGAT"	"AUCUGAA"
"TCGGGCT"	"AGCCCGA"
"ATATAAC"	"GUUAUAU"
"CTTCACC"	"GGUGAAG"
"TCAACAG"	"CUGUUGA"
"GCTCGGT"	"ACCGAGC"
"AAAACGT"	"ACGUUUU"
"TCGGGAA"	"UUCCCGA"
"AGGTCGT"	"ACGACCU"
"TGGATGG"	"CCAUCCA"
"TCATGAT"	"AUCAUGA"
"AAGGAGA"	"UCUCCUU"
"TGCATAT"	"AUAUGCA"
"AGCCACA"	"UGUGGCU"
"TGCTAGT"	"ACUAGCA"
"TTGGGAA"	"UUCCCAA"
"TTGGGGA"	"UCCCCAA"
"TGGGATC"	"GAUCCCA"
"TCATCTG"	"CAGAUGA"
"GAGACAG"	"CUGUCUC"
"CAGTCCA"	"UGGACUG"
"ACTAACT"	"AGUUAGU"
"ACCCCCT"	"AGGGGGU"
"AGGATCC"	"GGAUCCU"
"AAGATAG"	"CUAUCUU"
"TTCCGGT"	"ACCGGAA"
"CTGTGAG"	"CUCACAG"
"ACACAAG"	"CUUGUGU"
"AGGGCAT"	"AUGCCCU"
"TAGCAAT"	"AUUGCUA"
"CACTCCT"	"AGGAGUG"
"TCATACA"	"UGUAUGA"
"GGGGCAG"	"CUGCCCC"
"ATCGTAC"	"GUACGAU"
"TGAAAGG"	"CCUUUCA"
"TGACATC"	"GAUGUCA"
"AACCTGG"	"CCAGGUU"
"TTATGCA"	"UGCAUAA"
"GAAGGTC"	"GACCUUC"
"GAAACAT"	"AUGUUUC"
"AACAAAC"	"GUUUGUU"
"GAGTATT"	"AAUACUC"
"AAACCAC"	"GUGGUUU"
"ACATCAC"	"GUGAUGU"
"CAGGACA"	"UGUCCUG"
"CCTAAAT"	"AUUUAGG"
"TGCACCT"	"AGGUGCA"
"CACCCAG"	"CUGGGUG"
"ATGCACC"	"GGUGCAU"
"TTTGTGT"	"ACACAAA"
"GGGTATT"	"AAUACCC"
"GGAGTGC"	"GCACUCC"
"GTCAACA"	"UGUUGAC"
"TTTGCAC"	"GUGCAAA"
"GATTGTA"	"UACAAUC"
"GATTGGT"	"ACCAAUC"
"TTGAAAC"	"GUUUCAA"
"ATGTGTA"	"UACACAU"
"AGTGCTG"	"CAGCACU"
"AAATTTC"	"GAAAUUU"
"AATGTCA"	"UGACAUU"
"TTGACAC"	"GUGUCAA"
"GCTTCCT"	"AGGAAGC"
"TCGTGCA"	"UGCACGA"
"AAAGCGC"	"GCGCUUU"
"AAGCGCT"	"AGCGCUU"
"GAGGGGT"	"ACCCCUC"
"AAGTGCA"	"UGCACUU"
"AAAGTGC"	"GCACUUU"
"AGTGCTT"	"AAGCACU"
"CAAAGTG"	"CACUUUG"
"ACGCACT"	"AGUGCGU"
"AACGCGC"	"GCGCGUU"
"AAGGCGC"	"GCGCCUU"
"CTCCCAC"	"GUGGGAG"
"GGTGGGC"	"GCCCACC"
"GTGACAG"	"CUGUCAC"
"AACATTC"	"GAAUGUU"
"TTCTGCA"	"UGCAGAA"
"CAGCAAA"	"UUUGCUG"
"CGACCCA"	"UGGGUCG"
"ACAGGTG"	"CACCUGU"
"TATTACC"	"GGUAAUA"
"TAGCTTA"	"UAAGCUA"
"TCCATGC"	"GCAUGGA"
"AGAGTGA"	"UCACUCU"
"AAAGTTT"	"AAACUUU"
"TAGAACG"	"CGUUCUA"
"ACGCTCA"	"UGAGCGU"
"AGATGTG"	"CACAUCU"
"TCATTTG"	"CAAAUGA"
"TGAGAAT"	"AUUCUCA"
"AACTGGT"	"ACCAGUU"
"CAGTTCC"	"GGAACUG"
"GGGCGTA"	"UACGCCC"
"CAGAACA"	"UGUUCUG"
"AATTTTA"	"UAAAAUU"
"TTGTGTC"	"GACACAA"
"GAAGGCA"	"UGCCUUC"
"CCGAGCC"	"GGCUCGG"
"GTCATTG"	"CAAUGAC"
"ACAAGGT"	"ACCUUGU"
"ACTATAG"	"CUAUAGU"
"CTTTTCT"	"AGAAAAG"
"CTAGTAA"	"UUACUAG"
"TTCTCCC"	"GGGAGAA"
"GACACAT"	"AUGUGUC"
"TCCACTG"	"CAGUGGA"
"AAGGAAA"	"UUUCCUU"
"ATGGCGC"	"GCGCCAU"
"TCACTGG"	"CCAGUGA"
"ATGTCTG"	"CAGACAU"
"TAATACA"	"UGUAUUA"
"ATATTAT"	"AUAAUAU"
"CCTCCTG"	"CAGGAGG"
"TTCCTCA"	"UGAGGAA"
"CCGGTTC"	"GAACCGG"
"GCGCCTG"	"CAGGCGC"
"AGCCGCC"	"GGCGGCU"
"TGTATGC"	"GCAUACA"
"TGTCCTA"	"UAGGACA"
"AACAAAT"	"AUUUGUU"
"AACTAGA"	"UCUAGUU"
"TACAGGC"	"GCCUGUA"
"TGTTGCC"	"GGCAACA"
"TTGTGAC"	"GUCACAA"
"GGCTCTG"	"CAGAGCC"
"CTCCAGC"	"GCUGGAG"
"GAGACTG"	"CAGUCUC"
"TGCCCTG"	"CAGGGCA"
"CTGGAAA"	"UUUCCAG"
"GGCAGCG"	"CGCUGCC"
"TGAACGG"	"CCGUUCA"
"ACTGACA"	"UGUCAGU"
"TAATATC"	"GAUAUUA"
"ACTGTGT"	"ACACAGU"
"ACTGGCT"	"AGCCAGU"
"ACTGTTT"	"AAACAGU"
"TAAAGCT"	"AGCUUUA"
"CTGCTGA"	"UCAGCAG"
"ACCCGGC"	"GCCGGGU"
"ACATGGC"	"GCCAUGU"
"AATTATT"	"AAUAAUU"
"TCAACGG"	"CCGUUGA"
"ATCATGT"	"ACAUGAU"
"AAGCTCG"	"CGAGCUU"
"GAGGTAG"	"CUACCUC"
"CATACTT"	"AAGUAUG"
"ACCCGTA"	"UACGGGU"
"AGTTATC"	"GAUAACU"
"GCTTCTT"	"AAGAAGC"
"CAAATGC"	"GCAUUUG"
"ACCCTGT"	"ACAGGGU"
"AGCATTC"	"GAAUGCU"
"GACCCAC"	"GUGGGUC"
"GAGGATA"	"UAUCCUC"
"GGATGGT"	"ACCAUCC"
"GGAGTGT"	"ACACUCC"
"GTGTTCA"	"UGAACAC"
"AGGCCTT"	"AAGGCCU"
"CCCGTCC"	"GGACGGG"
"GGAGGGA"	"UCCCUCC"
"CTCTAGC"	"GCUAGAG"
"GAAGGAA"	"UUCCUUC"
"GGCATTG"	"CAAUGCC"
"CCCTGAG"	"CUCAGGG"
"ATTATTA"	"UAAUAAU"
"CTCAGGG"	"CCCUGAG"
"TGAAGCT"	"AGCUUCA"
"TGGAGAT"	"AUCUCCA"
"TTGGCAC"	"GUGCCAA"
"AAAGAGC"	"GCUCUUU"
"AATATAT"	"AUAUAUU"
"GGGGCCG"	"CGGCCCC"
"CTACAAA"	"UUUGUAG"
"GCTGGAT"	"AUCCAGC"
"TTTTTGC"	"GCAAAAA"
"GTGAGGT"	"ACCUCAC"
"TAGGGCC"	"GGCCCUA"
"TCATTCG"	"CGAAUGA"
"GCTCTAG"	"CUAGAGC"
"CGACCGG"	"CCGGUCG"
"CTCTTTC"	"GAAAGAG"
"CCGTGGC"	"GCCACGG"
"CAAAACT"	"AGUUUUG"
"GCTGGTA"	"UACCAGC"
"GTGACTG"	"CAGUCAC"
"GGGGAGC"	"GCUCCCC"
"ATGGCTT"	"AAGCCAU"
"CTCCATT"	"AAUGGAG"
"GCTGGTG"	"CACCAGC"
"CTACAGT"	"ACUGUAG"
"AGTGGTT"	"AACCACU"
"ATCTTCC"	"GGAAGAU"
"ATAAAGT"	"ACUUUAU"
"GTGCAGT"	"ACUGCAC"
"GATATCA"	"UGAUAUC"
"TCCAGTT"	"AACUGGA"
"GAGAACT"	"AGUUCUC"
"AAGTTCT"	"AGAACUU"
"AGTTCTG"	"CAGAACU"
"CTGGCTC"	"GAGCCAG"
"CTCCCAA"	"UUGGGAG"
"CGAGGAG"	"CUCCUCG"
"GGTTCTG"	"CAGAACC"
"CATTTTT"	"AAAAAUG"
"AGGTTAT"	"AUAACCU"
"TAATGCT"	"AGCAUUA"
"AGCAGCA"	"UGCUGCU"
"ACATTCA"	"UGAAUGU"
"TTGGCAA"	"UUGCCAA"
"ATGGCAC"	"GUGCCAU"
"GGAGAGA"	"UCUCUCC"
"AAAGAAT"	"AUUCUUU"
"GCTACAA"	"UUGUAGC"
"ATCCCTT"	"AAGGGAU"
"AAGGTGC"	"GCACCUU"
"GGCGGGG"	"CCCCGCC"
"GATATGT"	"ACAUAUC"
"AACGGAA"	"UUCCGUU"
"GAGTACC"	"GGUACUC"
"TGACCTA"	"UAGGUCA"
"GGGTCTT"	"AAGACCC"
"GGGGTTT"	"AAACCCC"
"GTAACAG"	"CUGUUAC"
"AGGTAGT"	"ACUACCU"
"GGGTAGA"	"UCUACCC"
"CCAGTGT"	"ACACUGG"
"GTTTTGC"	"GCAAAAC"
"ATCTTAC"	"GUAAGAU"
"GTCTTAC"	"GUAAGAC"
"TCCTATG"	"CAUAGGA"
"GTGGTTC"	"GAACCAC"
"TCCCTTT"	"AAAGGGA"
"CCTTCAT"	"AUGAAGG"
"AGCTTTT"	"AAAAGCU"
"AGCTTAT"	"AUAAGCU"
"GCCCCTG"	"CAGGGGC"
"AGTCCCT"	"AGGGACU"
"GCTTCCA"	"UGGAAGC"
"GTTCTTA"	"UAAGAAC"
"CCTTGGC"	"GCCAAGG"
"GCCTGTC"	"GACAGGC"
"AATCTCA"	"UGAGAUU"
"AATCTCT"	"AGAGAUU"
"ACTGCAT"	"AUGCAGU"
"TGTGCTT"	"AAGCACA"
"GATTGTC"	"GACAAUC"
"GTTCTTC"	"GAAGAAC"
"CCTGGCA"	"UGCCAGG"
"TCAGTAG"	"CUACUGA"
"GTGTATT"	"AAUACAC"
"AAGTCAC"	"GUGACUU"
"GCGCGGG"	"CCCGCGC"
"AGAGCAG"	"CUGCUCU"
"TCCCCAG"	"CUGGGGA"
"GGGTTCC"	"GGAACCC"
"GCCTACT"	"AGUAGGC"
"GAGGCTC"	"GAGCCUC"
"GGCGGAG"	"CUCCGCC"
"TTTTACC"	"GGUAAAA"
"TCAAGTA"	"UACUUGA"
"GGGCTTA"	"UAAGCCC"
"GAGCTTA"	"UAAGCUC"
"AGGAGCT"	"AGCUCCU"
"GGGCCCC"	"GGGGCCC"
"GGTTTAC"	"GUAAACC"
"CTGATTT"	"AAAUCAG"
"CTGGTTT"	"AAACCAG"
"TGGTTTC"	"GAAACCA"
"GACCGAT"	"AUCGGUC"
"CTCTGAC"	"GUCAGAG"
"CTTAAAC"	"GUUUAAG"
"CTTTAAC"	"GUUAAAG"
"TTAACAT"	"AUGUUAA"
"GTAAACA"	"UGUUUAC"
"GGCAAGA"	"UCUUGCC"
"CCTTTGC"	"GCAAAGG"
"GAGGGAC"	"GUCCCUC"
"TCAGGGC"	"GCCCUGA"
"CCTGAAT"	"AUUCAGG"
"GGGGACC"	"GGUCCCC"
"ACTCCAA"	"UUGGAGU"
"AACCTCG"	"CGAGGUU"
"ATAAAAT"	"AUUUUAU"
"GTGACTT"	"AAGUCAC"
"GATGTAT"	"AUACAUC"
"GCCCTGC"	"GCAGGGC"
"AGTGAGT"	"ACUCACU"
"TTCCAGA"	"UCUGGAA"
"AGGCGTC"	"GACGCCU"
"CTGGGCA"	"UGCCCAG"
"GCCAGCC"	"GGCUGGC"
"ATCTGAG"	"CUCAGAU"
"GGTGGTC"	"GACCACC"
"GGTTGTC"	"GACAACC"
"GCATCCC"	"GGGAUGC"
"CTAGTAG"	"CUACUAG"
"GGGGGGC"	"GCCCCCC"
"AGGTTTT"	"AAAACCU"
"TAGGTAT"	"AUACCUA"
"CAAGAGC"	"GCUCUUG"
"AACGGCT"	"AGCCGUU"
"ACAATAT"	"AUAUUGU"
"CCCTGTC"	"GACAGGG"
"TGCATTG"	"CAAUGCA"
"TATAAAG"	"CUUUAUA"
"GGGGTGC"	"GCACCCC"
"CTGACTC"	"GAGUCAG"
"GTCTGCC"	"GGCAGAC"
"GGCAGTG"	"CACUGCC"
"AGGCAGT"	"ACUGCCU"
"GAGGATG"	"CAUCCUC"
"TATCAGA"	"UCUGAUA"
"GGAGGCA"	"UGCCUCC"
"GTTGTAC"	"GUACAAC"
"CACTTGG"	"CCAAGUG"
"AAGACAT"	"AUGUCUU"
"ATCCTTG"	"CAAGGAU"
"AGGCACG"	"CGUGCCU"
"GGGTGGA"	"UCCACCC"
"GGGACTT"	"AAGUCCC"
"CTGTTGC"	"GCAACAG"
"AGTGGAT"	"AUCCACU"
"GATCGAC"	"GUCGAUC"
"CCTGGAC"	"GUCCAGG"
"AGGTCAC"	"GUGACCU"
"CTCAAAC"	"GUUUGAG"
"CTCAAAT"	"AUUUGAG"
"CTCAAAA"	"UUUUGAG"
"TATAATA"	"UAUUAUA"
"GTAGATT"	"AAUCUAC"
"TAGATTC"	"GAAUCUA"
"GTGGATA"	"UAUCCAC"
"GAGGTTG"	"CAACCUC"
"TCCTGAC"	"GUCAGGA"
"GGTAGAC"	"GUCUACC"
"GGTTGAC"	"GUCAACC"
"GCGAGGT"	"ACCUCGC"
"AAGTTGT"	"ACAACUU"
"GATCAGA"	"UCUGAUC"
"CAGGGCC"	"GGCCCUG"
"TGGGTTG"	"CAACCCA"
"AGCAATA"	"UAUUGCU"
"GTGCAGC"	"GCUGCAC"
"AGTAGAC"	"GUCUACU"
"GGTCGAC"	"GUCGACC"
"GAGGGGC"	"GCCCCUC"
"ATGACAC"	"GUGUCAU"
"GTCTTGC"	"GCAAGAC"
"CTTGGAG"	"CUCCAAG"
"ACGGTGA"	"UCACCGU"
"GAGTTAA"	"UUAACUC"
"TTTGCGA"	"UCGCAAA"
"TTTGCAA"	"UUGCAAA"
"TAGCAGC"	"GCUGCUA"
"CCCTATC"	"GAUAGGG"
"ATGTGCC"	"GGCACAU"
"GGGCCAG"	"CUGGCCC"
"ACTAGCT"	"AGCUAGU"
"TAGCCAA"	"UUGGCUA"
"TGTTCTT"	"AAGAACA"
"GCTGGGG"	"CCCCAGC"
"AGGGAGG"	"CCUCCCU"
"CAAGGTG"	"CACCUUG"
"CTGAAAG"	"CUUUCAG"
"AGACGGG"	"CCCGUCU"
"GAGGCTG"	"CAGCCUC"
"CCTGTAC"	"GUACAGG"
"TGGTTAT"	"AUAACCA"
"CCAGATA"	"UAUCUGG"
"GTCGTAT"	"AUACGAC"
"CATGGAT"	"AUCCAUG"
"GTGGGGA"	"UCCCCAC"
"TGTACAT"	"AUGUACA"
"AAGTTGC"	"GCAACUU"
"TTCAAGC"	"GCUUGAA"
"TAAGACT"	"AGUCUUA"
"AGTTCAG"	"CUGAACU"
"TGGACTT"	"AAGUCCA"
"AATCCTT"	"AAGGAUU"
"ATCCTTT"	"AAAGGAU"
"GGGGGAT"	"AUCCCCC"
"TCCTTGC"	"GCAAGGA"
"AGCAGCG"	"CGCUGCU"
"GACCCTG"	"CAGGGUC"
"GGAGCCA"	"UGGCUCC"
"ATTCAGG"	"CCUGAAU"
"ACTCCAG"	"CUGGAGU"
"ACTGCAG"	"CUGCAGU"
"ATCAGTG"	"CACUGAU"
"ACTCAGG"	"CCUGAGU"
"TGTCTTT"	"AAAGACA"
"ACTCAGC"	"GCUGAGU"
"TCACAGG"	"CCUGUGA"
"TCACAAG"	"CUUGUGA"
"TCTCAAG"	"CUUGAGA"
"ACTCTGG"	"CCAGAGU"
"TCTCCAA"	"UUGGAGA"
"TCTCGAG"	"CUCGAGA"
"TCTGGAG"	"CUCCAGA"
"CTCTAGA"	"UCUAGAG"
"TGCAAAG"	"CUUUGCA"
"CTCTGGA"	"UCCAGAG"
"TCTAGAG"	"CUCUAGA"
"CTCCAAA"	"UUUGGAG"
"TCCAGAG"	"CUCUGGA"
"TACAAAG"	"CUUUGUA"
"CTCTAAA"	"UUUAGAG"
"CTAGAGG"	"CCUCUAG"
"TCTTGAG"	"CUCAAGA"
"ATGCCTT"	"AAGGCAU"
"GAGAAAT"	"AUUUCUC"
"AAGGATT"	"AAUCCUU"
"CGGGGAT"	"AUCCCCG"
"CAGTAAA"	"UUUACUG"
"AAATCAA"	"UUGAUUU"
"TTTAACC"	"GGUUAAA"
"ATGAGCT"	"AGCUCAU"
"ATGGTAC"	"GUACCAU"
"GCCTTCC"	"GGAAGGC"
"ATCCAGC"	"GCUGGAU"
"TCAAGGA"	"UCCUUGA"
"TGCTCTG"	"CAGAGCA"
"GAGTGTG"	"CACACUC"
"TTCTAAT"	"AUUAGAA"
"AGATAAA"	"UUUAUCU"
"CGCGGTT"	"AACCGCG"
"AATGATT"	"AAUCAUU"
"TACAGTT"	"AACUGUA"
"TATGGTT"	"AACCAUA"
"TAGCACA"	"UGUGCUA"
"TGGCCAC"	"GUGGCCA"
"GAGAACC"	"GGUUCUC"
"AAATCCC"	"GGGAUUU"
"GGGGTCC"	"GGACCCC"
"AGTACCA"	"UGGUACU"
"GGGGGAA"	"UUCCCCC"
"TGAGTCT"	"AGACUCA"
"TGCTGAC"	"GUCAGCA"
"GGGTTTA"	"UAAACCC"
"TCCCTCT"	"AGAGGGA"
"TTAGGTA"	"UACCUAA"
"TTAGGAT"	"AUCCUAA"
"AACCCTA"	"UAGGGUU"
"TGTTGAA"	"UUCAACA"
"GAGGTTA"	"UAACCUC"
"GGTTGCC"	"GGCAACC"
"ACCCATT"	"AAUGGGU"
"TCCCTGA"	"UCAGGGA"
"GGAAGCC"	"GGCUUCC"
"TCCAGCC"	"GGCUGGA"
"CGGGAGA"	"UCUCCCG"
"GGTGCGG"	"CCGCACC"
"CTTCAAC"	"GUUGAAG"
"GGAAGAC"	"GUCUUCC"
"ATCCATC"	"GAUGGAU"
"GCGGGGC"	"GCCCCGC"
"ATGGTTG"	"CAACCAU"
"GGAGGAA"	"UUCCUCC"
"GAGACCT"	"AGGUCUC"
"CCAGTAC"	"GUACUGG"
"AGTAACA"	"UGUUACU"
"CAGGAAC"	"GUUCCUG"
"GGCCCCA"	"UGGGGCC"
"ATACCTC"	"GAGGUAU"
"CCATTAC"	"GUAAUGG"
"TTGGGAG"	"CUCCCAA"
"ACTCAAA"	"UUUGAGU"
"ATGGCTG"	"CAGCCAU"
"ACTTGGA"	"UCCAAGU"
"ATTCAGA"	"UCUGAAU"
"CTTTGGT"	"ACCAAAG"
"GGTTGGG"	"CCCAACC"
"GGTGGGG"	"CCCCACC"
"GGGACGG"	"CCGUCCC"
"GTCTACT"	"AGUAGAC"
"CTTCTCT"	"AGAGAAG"
"CAATAAA"	"UUUAUUG"
